17 17 17 17 17 17 17 17 17 17 17 17 17 17 17 17
17 17 17 17 17 17 17 17 17 17 17 17 17 17 17 17
17 17 17 17 17 17 17 17 17 17 17 17 17 17 17 17
17  2  4  6  8 13 23  4  6  8 10 17 22  6  8 17
17  3  5  7  9 10  2  5  7  9 11 15 24  7  9 17
24 -1 -1 -1 -1 11  3 -1 -1 -1 -1  2  4 -1 -1 13
22 -1 -1 -1 -1 -1 -1 -1 -1 -1 -1  3  5 -1 -1 17
23 -1 -1 -1 -1 -1 -1 -1 -1 -1 -1 -1 -1 -1 -1 15
24 -1 -1 -1 -1 -1 -1 -1 -1 -1 -1 -1 -1 -1 -1 14
22 -1 -1 -1 -1 -1 -1 -1 -1 -1 -1 -1 -1 -1 -1 17
23 -1 -1 -1 -1 -1 -1 -1 -1 -1 -1 -1 -1 -1 -1 15
24 -1 -1 -1 -1 -1 -1 -1 -1 -1 -1 -1 -1 -1 -1 13
22 -1 -1 -1 -1 -1 -1 -1 -1 -1 -1 -1 -1 -1 -1 14
23 -1 -1 -1 -1 -1 -1 -1 -1 -1 12 21 -1 -1 -1 17
23 -1 -1 -1 -1 -1 -1 -1 -1 12 17 20 21 -1 -1 13
17 16 17 18 17 19 20 17 18 17 17 17 17 16 18 17
