17 17 17 17 17 17 17 17 17 17 17 17 17 17 17 17
17 17 17 17 17 17 17 17 17 17 17 17 17 17 17 17
17 17 17 17 17 1 2 2 2 3 17 17 17 17 17 17
17  2  4  6 8 14 23 4  6  22 10 17 22  6  8 17
17  3  5  7  9 2  2 2 2 2 2 2 2  2  2 17
24 -1 -1 -1 -1  0   2  2 2  1 -1 -1 -1 2 2 13
22 -1 -1 -1 -1 -1 -1 -1 -1 -1 -1 -1 -1 0 2 17
23 -1 -1 -1 -1 -1 -1 -1 -1 -1 -1 -1 -1 -1 -1 15
24 -1 -1 -1 -1 -1 -1 -1 -1 -1 -1 -1 -1 -1 -1 14
22 -1 -1 -1 -1 -1 -1 -1 -1 -1 -1 -1 -1 -1 -1 17
23 -1 -1 -1 -1 -1 -1 -1 -1 -1 -1 -1 -1 -1 -1 15
24 -1 -1 -1 -1 -1 -1 -1 -1 -1 -1 -1 -1 -1 -1 13
22 -1 -1 -1 -1 -1 -1 -1 -1 -1 -1 -1 -1 -1 -1 14
23 -1 -1 -1 -1 -1 -1 -1 -1 -1 12 21 -1 -1 -1 17
23 -1 -1 -1 -1 -1 -1 -1 -1 12 17 20 21 -1 -1 13
17 16 17 18 17 19 20 17 18 17 17 17 17 16 18 17
